.0...00..S
.0F0......
..0..0....
.0.0.....0
..........
..........
....0.0.0.
.0.0......
0........0
..0.....00